1111111111111111111
1A000000010000000L1
1011011101011101101
1L00000000000000001
1011010111110101101
1000010001000100001
1111011101011101111
111101L00000L101111
11110101PPP10101111
1000000123410000001
1111010111110101111
1111010000000101111
1111010111110101111
10000000010000000L1
1011011101011101101
1001000000000001001
1101010111110101011
1000010001000100001
1011111101011111101
1000000005000000001
1111111111111111111