1111111111111111111
10000000010000000L1
1011011101011101101
1000000000000000001
1011010111110101101
1000010001000100001
1111011101011101111
1111010000000101111
111101L11P11L101111
0000000123410000000
1111010111110101111
1111010000000101111
1111010111110101111
1000000001000000001
1011011101011101101
1001000000000001001
1101010111110101011
1L000100010001000L1
1011111101011111101
1000000000000000051
1111111111111111111